GGGGGGGGGGGGGG
GGRGGFFGGGGRGG
GGGGGFGGGGGGGG
GGRGGGGGGGRGGG
GGGFFFFGGGGGGG
GGGGGGGGGGGGGG